LLLL##LLLL
LLL####LLL
LL######LL
L########L
##########
##########
L########L
LL######LL
LLL####LLL
LLLL##LLLL