##########LLL
LLL########LL
LL###########
########LLLLL
######LLLLLLL
######LLLLLLL
#######LLLLLL
########LLLLL
#############
L##########LL
LL########LLL
L###########L
###########LL