######L######
#L####L####L#
######L######
######L######
######L######
######L######
LLLLLLLLLLLLL
######L######
######L######
######L######
######L######
#L####L####L#
######L######